    11111 111111
    11111 101111
11111111111
111110111111
10S0   0011
1111    11111
111111   1111
111111111111
